###############################################################################################################################################################################
#                                                                                                                                                                            #
#                                                                                                                                                            F                #
#                                                                                                                                                                            #
#                                                                                                                                                                            #
#                                                                                 ############################################################################################
#                                                                                 #             
#                                                                ##################                                                                                        
#          B   ++                                                                                                              
#          ##############   ####                                                                                                          
#          #                  #                     ########        ############      +               F   ################                                +                     +                   +             
############################################################################################################################################################################################
