###############################################################################################################################################################################
#                                                                                                                                                                            #
#                                                                                                                                                                           #
#                                                                                                                                                                            #
#                                                                                                +                                                                            #
#                                                                                 ############################################################################################
#                                                                       ##########          #                                                                                                                      
#                                                ++                ##################                                                                                                 +                          ++                         
#          B                   ####   ###########################                                                                             ########################################################################                                                
#          ##############   ####                                                                                                  ######  #####                                                                                                 
#          #                  #                                    ########        ############      +                  ################                                ++                     +                   +++             F
#########################################               #############################################################################################################################################################################
                                        ###################